ー。、┌┘.;©/・〜+§ヵ×>◆「　」

あいうえお	ゔ			アイウエオ	ヴ
かきくけこ	がぎぐげご	カキクケコ	ガギグゲゴ
さしすせそ	ざじずぜぞ	サシスセソ	ザジズゼゾ
たちつてと	だぢづでど	タチツテト	ダヂヅデド
なにぬねの				ナニヌネノ
はひふへほ	ばびぶべぼ	ハヒフヘホ	バビブベボ
まみむめも	ぱぴぷぺぽ	マミムメモ	パピプペポ
や ゆ よ					ヤ ユ ヨ
らりるれろ				ラリルレロ
わ を ん					ワ ヲ ン
ぁぃぅぇぉ 				ァィゥェォ 
っゃゅょ					ッャュョ

アイウエオ カキクケコ サシスセソ タチツテト
ナニヌネノ ハヒフヘホ マミムメモ ヤユヨ ラリルレロ ワ ヲ ン

がぎぐげご ざじずぜぞ だぢづでど ばびぶべぼ ゔ
ガギグゲゴ ザジズゼゾ ダヂヅデド バビブベボ ヴ

ぱぴぷぺぽ
パピプペポ

ぁぃぅぇぉ っゃゅょ
ァィゥェォ ッャュョ

です



か		カ
き		キ
け		ケ
こ		コ

せ		セ

へ		ヘ

む		ム
も		モ

や		ヤ

り		リ